-	ー
~	〜
.	。
,	、
;/	・
;.	…
;,	‥
;d	←
;h	↓
;t	↑
;n	→
;-	〜
;[	『
;]	』
[	「
]	」
p	ー
P	＿
y	・
Y	？
'	ん
"	〜
va	ゔぁ
vi	ゔぃ
vu	ゔ
ve	ゔぇ
vo	ゔぉ
v;	ゔぁん
vx	ゔぃん
vk	ゔん
vj	ゔぇん
vq	ゔぉん
v'	ゔぁい
v.	ゔぇい
v,	ゔぉう
vp	ゔう
vy	ゔい
vha	ゔゃ
vhi	ゔぃ
vhu	ゔゅ
vhe	ゔぇ
vho	ゔょ
vh;	ゔゃん
vhx	ゔぃん
vhk	ゔゅん
vhj	ゔぇん
vhq	ゔょん
vh'	ゔゃい
vh.	ゔぇい
vh,	ゔょう
vhp	ゔゅう
vhy	ゔゅい
qq	っ	q
vv	っ	v
ll	っ	l
kk	っ	k
cc	っ	c
gg	っ	g
ss	っ	s
zz	っ	z
tt	っ	t
dd	っ	d
hh	っ	h
ff	っ	f
bb	っ	b
mm	っ	m
rr	っ	r
ww	っ	w
xx	っ	x
www	w	ww
kha	きゃ
khi	きぃ
khu	きゅ
khe	きぇ
kho	きょ
kh;	きゃん
khx	きぃん
khk	きゅん
khj	きぇん
khq	きょん
kh'	きゃい
kh.	きぇい
kh,	きょう
khp	きゅう
khy	きゅい
cna	きゃ
cni	きぃ
cnu	きゅ
cne	きぇ
cno	きょ
cn;	きゃん
cnx	きぃん
cnk	きゅん
cnj	きぇん
cnq	きょん
cn'	きゃい
cn.	きぇい
cn,	きょう
cnp	きゅう
cny	きゅい
gna	ぎゃ
gni	ぎぃ
gnu	ぎゅ
gne	ぎぇ
gno	ぎょ
gn;	ぎゃん
gnx	ぎぃん
gnk	ぎゅん
gnj	ぎぇん
gnq	ぎょん
gn'	ぎゃい
gn.	ぎぇい
gn,	ぎょう
gnp	ぎゅう
gny	ぎゅい
sha	しゃ
shi	しぃ
shu	しゅ
she	しぇ
sho	しょ
sh;	しゃん
shx	しぃん
shk	しゅん
shj	しぇん
shq	しょん
sh'	しゃい
sh.	しぇい
sh,	しょう
shp	しゅう
shy	しゅい
zha	じゃ
zhi	じぃ
zhu	じゅ
zhe	じぇ
zho	じょ
zh;	じゃん
zhx	じぃん
zhk	じゅん
zhj	じぇん
zhq	じょん
zh'	じゃい
zh.	じぇい
zh,	じょう
zhp	じゅう
zhy	じゅい
tna	ちゃ
tni	ちぃ
tnu	ちゅ
tne	ちぇ
tno	ちょ
tn;	ちゃん
tnx	ちぃん
tnk	ちゅん
tnj	ちぇん
tnq	ちょん
tn'	ちゃい
tn.	ちぇい
tn,	ちょう
tnp	ちゅう
tny	ちゅい
dna	ぢゃ
dni	ぢぃ
dnu	ぢゅ
dne	ぢぇ
dno	ぢょ
dn;	ぢゃん
dnx	ぢぃん
dnk	ぢゅん
dnj	ぢぇん
dnq	ぢょん
dn'	ぢゃい
dn.	ぢぇい
dn,	ぢょう
dnp	ぢゅう
dny	ぢゅい
tsa	つぁ
tsi	つぃ
tsu	つぅ
tse	つぇ
tso	つぉ
ts;	つぁん
tsx	つぃん
tsk	つぅん
tsj	つぇん
tsq	つぉん
ts'	つぁい
ts.	つぇい
ts,	つぉう
tsp	つぅう
tsy	つぅい
tha	てゃ
thi	てぃ
thu	てゅ
the	てぇ
tho	てょ
th;	てゃん
thx	てぃん
thk	てゅん
thj	てぇん
thq	てょん
th'	てゃい
th.	てぇい
th,	てょう
thp	てゅう
thy	てゅい
dha	でゃ
dhi	でぃ
dhu	でゅ
dhe	でぇ
dho	でょ
dh;	でゃん
dhx	でぃん
dhk	でゅん
dhj	でぇん
dhq	でょん
dh'	でゃい
dh.	でぇい
dh,	でょう
dhp	でゅう
dhy	でゅい
twa	とぁ
twi	とぃ
twu	とぅ
twe	とぇ
two	とぉ
tw;	とぁん
twx	とぃん
twk	とぅん
twj	とぇん
twq	とぉん
tw'	とぁい
tw.	とぇい
tw,	とぉう
twp	とぅう
twy	とぅい
dwa	どぁ
dwi	どぃ
dwu	どぅ
dwe	どぇ
dwo	どぉ
dw;	どぁん
dwx	どぃん
dwk	どぅん
dwj	どぇん
dwq	どぉん
dw'	どぁい
dw.	どぇい
dw,	どぉう
dwp	どぅう
dwy	どぅい
nha	にゃ
nhi	にぃ
nhu	にゅ
nhe	にぇ
nho	にょ
nh;	にゃん
nhx	にぃん
nhk	にゅん
nhj	にぇん
nhq	にょん
nh'	にゃい
nh.	にぇい
nh,	にょう
nhp	にゅう
nhy	にゅい
hna	ひゃ
hni	ひぃ
hnu	ひゅ
hne	ひぇ
hno	ひょ
hn;	ひゃん
hnx	ひぃん
hnk	ひゅん
hnj	ひぇん
hnq	ひょん
hn'	ひゃい
hn.	ひぇい
hn,	ひょう
hnp	ひゅう
hny	ひゅい
bna	びゃ
bni	びぃ
bnu	びゅ
bne	びぇ
bno	びょ
bn;	びゃん
bnx	びぃん
bnk	びゅん
bnj	びぇん
bnq	びょん
bn'	びゃい
bn.	びぇい
bn,	びょう
bnp	びゅう
bny	びゅい
lha	ぴゃ
lhi	ぴぃ
lhu	ぴゅ
lhe	ぴぇ
lho	ぴょ
lh;	ぴゃん
lhx	ぴぃん
lhk	ぴゅん
lhj	ぴぇん
lhq	ぴょん
lh'	ぴゃい
lh.	ぴぇい
lh,	ぴょう
lhp	ぴゅう
lhy	ぴゅい
fa	や
fi	ふぃ
fu	ゆ
fe	いぇ
fo	よ
f;	やん
fx	ふぃん
fk	ゆん
fj	いぇん
fq	よん
f'	やい
f.	いぇい
f,	よう
fp	ゆう
fy	ゆい
fna	ふゃ
fni	ふぃ
fnu	ふゅ
fne	ふぇ
fno	ふょ
fn;	ふゃん
fnx	ふぃん
fnk	ふゅん
fnj	ふぇん
fnq	ふょん
fn'	ふゃい
fn.	ふぇい
fn,	ふょう
fnp	ふゅう
fny	ふゅい
hwa	ふぁ
hwi	ふぃ
hwu	ふぅ
hwe	ふぇ
hwo	ふぉ
hw;	ふぁん
hwx	ふぃん
hwj	ふぇん
hwk	ふぅん
hwq	ふぉん
hw'	ふぁい
hw.	ふぇい
hw,	ふぉう
hwp	ふぅう
hwy	ふぅい
mna	みゃ
mni	みぃ
mnu	みゅ
mne	みぇ
mno	みょ
mn;	みゃん
mnx	みぃん
mnk	みゅん
mnj	みぇん
mnq	みょん
mn'	みゃい
mn.	みぇい
mn,	みょう
mnp	みゅう
mny	みゅい
rha	りゃ
rhi	りぃ
rhu	りゅ
rhe	りぇ
rho	りょ
rh;	りゃん
rhx	りぃん
rhk	りゅん
rhj	りぇん
rhq	りょん
rh'	りゃい
rh.	りぇい
rh,	りょう
rhp	りゅう
rhy	りゅい
nn	ん
n	ん
a	あ
i	い
u	う
e	え
o	お
xa	ぁ
xi	ぃ
xu	ぅ
xe	ぇ
xo	ぉ
x;	ぁん
xk	ぅん
xj	ぇん
xq	ぉん
x'	ぁい
x.	ぇい
x,	ぉう
xp	ぅう
xy	ぅい
ka	か
ki	き
ku	く
ke	け
ko	こ
k;	かん
kx	きん
kj	けん
kq	こん
k'	かい
k.	けい
k,	こう
kp	くう
ky	くい
ca	か
ci	き
cu	く
ce	け
co	こ
c;	かん
cx	きん
ck	くん
cj	けん
cq	こん
c'	かい
c.	けい
c,	こう
cp	くう
cy	くい
xka	ヵ
xke	ヶ
xk;	ヵん
xkj	ヶん
xk'	ヵい
xk.	ヶい
xca	ヵ
xce	ヶ
xc;	ヵん
xcj	ヶん
xc'	ヵい
xc.	ヶい
ga	が
gi	ぎ
gu	ぐ
ge	げ
go	ご
g;	がん
gx	ぎん
gk	ぐん
gj	げん
gq	ごん
g'	がい
g.	げい
g,	ごう
gp	ぐう
gy	ぐい
sa	さ
si	し
su	す
se	せ
so	そ
s;	さん
sx	しん
sk	すん
sj	せん
sq	そん
s'	さい
s.	せい
s,	そう
sp	すう
sy	すい
qa	くぁ
qi	くぃ
qu	くぅ
qe	くぇ
qo	くぉ
q;	くぁん
qx	くぃん
qk	くぅん
qj	くぇん
q'	くぁい
q.	くぇい
q,	くぉう
qp	くぅう
qy	くぅい
qha	くゃ
qhi	くぃ
qhu	くゅ
qhe	くぇ
qho	くょ
qh;	くゃん
qhx	くぃん
qhk	くゅん
qhj	くぇん
qhq	くょん
qh'	くゃい
qh.	くぇい
qh,	くょう
qhp	くゅう
qhy	くゅい
qwa	くゎ
qw;	くゎん
qw'	くゎい
kwa	くぁ
kwi	くぃ
kwu	くぅ
kwe	くぇ
kwo	くぉ
kw;	くぁん
kwx	くぃん
kwk	くぅん
kwj	くぇん
kwq	くぉん
kw'	くぁい
kw.	くぇい
kw,	くぉう
kwp	くぅう
kwy	くぅい
cwa	くぁ
cwi	くぃ
cwu	くぅ
cwe	くぇ
cwo	くぉ
cw;	くぁん
cwx	くぃん
cwk	くぅん
cwj	くぇん
cwq	くぉん
cw'	くぁい
cw.	くぇい
cw,	くぉう
cwp	くぅう
cwy	くぅい
gwa	ぐぁ
gwi	ぐぃ
gwu	ぐぅ
gwe	ぐぇ
gwo	ぐぉ
gw;	ぐぁん
gwx	ぐぃん
gwk	ぐぅん
gwj	ぐぇん
gwq	ぐぉん
gw'	ぐぁい
gw.	ぐぇい
gw,	ぐぉう
gwp	ぐぅう
gwy	ぐぅい
swa	すぁ
swi	すぃ
swu	すぅ
swe	すぇ
swo	すぉ
sw;	すぁん
swx	すぃん
swk	すぅん
swj	すぇん
swq	すぉん
sw'	すぁい
sw.	すぇい
sw,	すぉう
swp	すぅう
swy	すぅい
zwa	ずぁ
zwi	ずぃ
zwu	ずぅ
zwe	ずぇ
zwo	ずぉ
zw;	ずぁん
zwx	ずぃん
zwk	ずぅん
zwj	ずぇん
zwq	ずぉん
zw'	ずぁい
zw.	ずぇい
zw,	ずぉう
zwp	ずぅう
zwy	ずぅい
za	ざ
zi	じ
zu	ず
ze	ぜ
zo	ぞ
z;	ざん
zx	じん
zk	ずん
zj	ぜん
zq	ぞん
z'	ざい
z.	ぜい
z,	ぞう
zp	ずう
zy	ずい
ta	た
ti	ち
tu	つ
te	て
to	と
t;	たん
tx	ちん
tk	つん
tj	てん
tq	とん
t'	たい
t.	てい
t,	とう
tp	つう
ty	つい
da	だ
di	ぢ
du	づ
de	で
do	ど
d;	だん
dx	ぢん
dk	づん
dj	でん
dq	どん
d'	だい
d.	でい
d,	どう
dp	づう
dy	づい
xtu	っ
xtk	っん
na	な
ni	に
nu	ぬ
ne	ね
no	の
n;	なん
nx	にん
nk	ぬん
nj	ねん
nq	のん
n'	ない
n.	ねい
n,	のう
np	ぬう
ny	ぬい
ha	は
hi	ひ
hu	ふ
he	へ
ho	ほ
h;	はん
hx	ひん
hk	ふん
hj	へん
hq	ほん
h'	はい
h.	へい
h,	ほう
hp	ふう
hy	ふい
ba	ば
bi	び
bu	ぶ
be	べ
bo	ぼ
b;	ばん
bx	びん
bk	ぶん
bj	べん
bq	ぼん
b'	ばい
b.	べい
b,	ぼう
bp	ぶう
by	ぶい
la	ぱ
li	ぴ
lu	ぷ
le	ぺ
lo	ぽ
l;	ぱん
lx	ぴん
lk	ぷん
lj	ぺん
lq	ぽん
l'	ぱい
l.	ぺい
l,	ぽう
lp	ぷう
ly	ぷい
ma	ま
mi	み
mu	む
me	め
mo	も
m;	まん
mx	みん
mk	むん
mj	めん
mq	もん
m'	まい
m.	めい
m,	もう
mp	むう
my	むい
xha	ゃ
xh;	ゃん
xh'	ゃい
xfa	ゃ
xf;	ゃん
xf'	ゃい
wni	ゐ
wnx	ゐん
xhu	ゅ
xhk	ゅん
xhp	ゅう
xhy	ゅい
xfu	ゅ
xfk	ゅん
xfp	ゅう
xfy	ゅい
wne	ゑ
wnj	ゑん
wn.	ゑい
xho	ょ
xhq	ょん
xh,	ょう
xfo	ょ
xfq	ょん
xf,	ょう
ra	ら
ri	り
ru	る
re	れ
ro	ろ
r;	らん
rx	りん
rk	るん
rj	れん
rq	ろん
r'	らい
r.	れい
r,	ろう
rp	るう
ry	るい
xwa	ゎ
xw;	ゎん
xw'	ゎい
wa	わ
wi	うぃ
wu	うぅ
we	うぇ
wo	を
w;	わん
wx	うぃん
wk	うぅん
wj	うぇん
wq	をん
w'	わい
w.	うぇい
w,	をう
wp	うぅう
wy	うぅい
wha	うぁ
whi	うぃ
whu	うぅ
whe	うぇ
who	うぉ
wh;	うぁん
whx	うぃん
whk	うぅん
whj	うぇん
whq	うぉん
wh'	うぁい
wh.	うぇい
wh,	うぉう
whp	うぅう
why	うぅい
